A #######################################
        #   # #   # #       #   # #   # #
# ##### # ### # ### # ##### ### # ### # #
# #         #   # #   #   #     # #     #
### ######### ### # ##### ##### # # # # #
# #         #     # # #       #     # # #
# ### # ####### # ### ##### ### ##### # #
#     #     #   #         # # # # #   # #
######### # # # # # ### # # # # # # ### #
#       # #   # # # #   #     #   # #   #
# # ### ### # ##### ####### ### ### # # #
# # # #   # #     #   #   # #     # # # #
# ### # ### ### ##### # ### # # ##### ###
#   # #       # # #   #   #   # # # # # #
# # # ####### ### ### ### ##### # # # # #
# #   #   #   #     #     #     #   #   #
######### ### # ##### ### # ### # # # # #
# #   #   #       # # # # # #   # #   # #
# ### # ### # ##### # # ##### ### ##### #
# #         #       #       #   # #   # #
# ### # # # ### ### ####### ####### #####
# #   # # # #   #       #     #   #   # #
# # ####### ### # # ### ### # ### # # # #
#       #   #   # #   # # # #       #   #
# # ### ##### # # ####### # # # ### #####
# # # # #   # # # #   # #   # # # # #   #
##### # # # # # ### # # # # ### # # # ###
# #   # # #   # #   #   # # #   #   #   #
# ### # ### ### ### # ### ### # # ### # #
#       #   # # #   #     #   # # #   # #
##### ####### # # ### ##### ##### # ### #
#       #       # # # #       # #     # #
# ### ####### ##### ### # ##### # #######
# #       #   # # #     #   #   #   #   #
# # ### # ### # # # ####### # # ### ### #
# #   # # #   # #   #   # #   # # # #   #
##### ####### # ##### ### ##### # ### ###
#     #     #     #   #   # #       #   #
# # # # # # # ####### ### # ####### # # #
# # # # # #         #                 # B
######################################### 